11111111111111111111111
10000000000011000000001
11011110000000000000011
10000000000000000011011
11111111111111111111111