1111111111111111111111111
1000000000000000000000001
1000110000000111100000001
1000000000000000000000001
1000000110000000000000001
1000000000000000000000001
1000000000000000000000001
1000010000000011111100001
1000000000000000000000001
1000000000000000111111001
1000000000000000000000001
1111111111111111111111111