                  1111111111      11111111111111
                  10000000001
                  10000000S01
                  1100000001
                  111111111
1111111111111111111
1000000000000000001
1111111111111111111