11111111
10110101
10100101
10100001
11111111