101111111   11111111111111
1001111111
1101111111111111111111
1000000000000000001111
11111111111111111111111