NO ./images/east.xpm
SO ./images/north.xpm
WE ./images/west.xpm

EA ./images/south.xpm

F 220,100,0
C 225,30,0

        1111111111111111111111111
        1000000000110000000000001
        1011000001110000000000001
        1001000000000000000000001
111111111011000001110000000000001
100000000011000001110111111111111
11110111111111011100000010001
111101111111110111010100100011111111111111111
110000001101010111000000000010000000000000001
100000000000000011000000000010000000000000001
1000000N0000000011010100000010000000000000001
110000011101010111110111101011100000000000001
11110111 1110101 10111101000111111111111111111
11111111 1111111 11111111111111111111111111111